OO1OOOOOOOOOOOO
XXXOOOOOOOOOOOO
OOXOO1OOOOOOOOO
OOXXXXXOOOOOOOO
OOOOOOXXXOOOOOO
OOOOOOOOXXXXXXX
OOOOOOOO1OOOOOO