OO1OOOOOOOOOOOO
XXXOOOOOOOOOOOO
OOXOO1OOOOOOOOO
OOXXXXXXOOOOOOO
OOOOOOOXXXXXOOO
OOOOOOOOOOOXXXX
OOOOOOOO1OOOOOO