OOOOOOOOOO
XXXOOOOOOO
OOXOOOOOOO
OOXXXXXXOO
OOOOOOOXXX