OOOOOOOOOOOOOOO
XXXOOOOOOOOOOOO
OOXOO1OOOOOOOOO
OOXXXXXXOOOOOOO
OOOOOOOXXXXXOOO
OOOOOOOOOOOXOOO
OOOOOOOO1OOXXXX
OOOOOOOOOOOOOOO
