OO1OOOOOOOOOOOO
XXXXXXX1OOOOOOO
OOOOOOXOOOOOOOO
OOOOOOXOOOOOOOO
OOOOO1XXXXXO1OO
OOOOOOOOO1XXXXX
OOOOOOOOOOOOOOO