OO1OOOOOOOOOOOO
XXXOOOOOOOOOOOO
OOXOO1OOOOOOOOO
OOXXXXXOOOOOOOO
OOOOOOXOOOOOOOO
OOOOOOXXXXXXXXX
OOOOOOOO1OOOOOO