OO1OOOOOOOOOOOO
XXXOOOOOOOOOOOO
OOXOO1OOOOOOOOO
OOXXXXXOOOOOOOO
OOOOOOXXXXXXOOO
OOOOOOOOOOOXXXX
OOOOOOOO1OOOOOO